2,2,2,0,0,0,0,0,0
0,0,0,0,0,0,0,0,0
0,0,0,0,0,0,0,0,0
0,0,0,0,0,0,0,0,0
0,0,0,0,0,0,0,0,0
0,0,0,0,0,0,0,0,0
0,0,0,0,0,0,0,0,0
0,0,0,0,0,0,17,0,0
0,99,82,99,82,99,17,0,0
0,99,72,99,72,99,0,17,0
0,91,91,91,91,50,0,0,0
0,81,82,71,82,61,0,0,0
0,71,92,61,72,71,0,0,0,0,0,0,0,0,0,1,2,3,2,2
2,2,2,2,2,2,4,0,0,1,4,0,0,1,3,14,12,12,12,14
12,12,12,12,12,12,13,0,0,11,13,0,0,11,12,12,14,12,12,12,2,2,2,2,2,2